XXXXXXXXXXXXXXXXXXXXX
X   X   X   X   X   X
X   F   F   F   L  VX
X   X   X   X   X   X
XXXXXXXXXXXXXXXXXXXXX
M

