XXXXXXX
X X   X
X X   X
X     X
X   X X
X   XVX
XXXXXXX