XXXXXXX
X     X
XXX   X
X     X
X   XXX
X    VX
XXXXXXX