XXXXXXXXX
X X  X  X
X   X X X
X X   X X
X   X   X
X X  X  X
X  X  X X
X X  X VX
XXXXXXXXX