XXXXXXXXXXXXX
X   X   X   X
X   F   L  VX
X   X   X   X
XXXXXXXXXXXXX
M

