XXXXXXXXXXXXXXXXX
X   X   X   X   X
X   L   L   L  VX
X   X   X   X   X
XXXXXXXXXXXXXXXXX
M

